000bbbbbbbbbb00
0w0w0w0w0w0w0w0
b0000000000000b
0w0w0w0w0w0w0w0
000000000000000
0w0w0w0w0w0w0w0
000000000000000
0w0w0w0w0w0w0w0
000000000000000
0w0w0w0w0w0w0w0
000000000000000
0w0w0w0w0w0w0w0
b0000000000000b
0w0w0w0w0w0w0w0
00bbbbbbbbbbb00