0000bbbbbbb0000
0w0w0w0w0w0w0w0
b0000000000000b
0w0w0w0w0w0w0w0
000000000000000
0w0w0w0w0w0w0w0
000000000000000
000w000w000w000
000000000000000
0w0w0w0w0w0w0w0
000000000000000
ww00ww000ww00ww
b0000000000000b
0w0w0w0w0w0w0w0
00bbbbbbbbbbb00