00bbbbbbbbbbb00
00bbbbbbbbbbb00
00bbbbbbbbbbb00
000000000000000
000000000000000
0w0w0w0w0w0w0w0
0w0w0w0w0w0w0w0
0w0w0w0w0w0w0w0
0w0w0w0w0w0w0w0
0w0w0w0w0w0w0w0
0w0w0w0w0w0w0w0
0w0w00ww000w0w0
b0000000000000b
0w0w0w0w0w0w0w0
000bbbbbbbbb000