00bbbbbbbbbbb000
0wwwwwwwwwwwww00
b0000000000000b0
0w0w0w0w0w0w0w00
0000000000000000
0w0w0w0w0w0w0w00
0000000000000000
0w0w0w0w0w0w0w00
0000000000000000